11111111111111111111111111111111111111111111111111111111111111111111111111111111111111111111111
10100011111011111111000000000010001100011000101111111111111100100000000001000000000000000000001
10101110000000000000011101111010100001000010100000000000000001110101011111011111111111111111111
10100000111111111111001000001010101111111110101111111111111111000101000001011000000000000000001
10111111111111111111101011101000101011000110000000000000000000011101111101011011111111111011111
10000000000000000100001010101111111010010111111111111111111111111101101101011000000000001000001
11111111011111110111111010100000000010110000010001000000000000000001000001011011111011111110111
10000000010000010001000010111111111010011111110101011111111111111101011111011111111011111110101
11011111110111111101111110100000001011010000000101010000000000000001000000010001111111111000101
11011110110000000000000000001111101011000111010101010111111111111111011110111100000000000010001
11000000011101111111111111111111101011111101010101010000000000011111111111111101111111101111101
11111111111101000000000000000000101011100001010101011111110111111000101100110001111000000001001
10000000000101011111111111011111101010110101010101011000010000000010001110000100000011111110101
10111111111101010111111100010000101010110101010101011101110111101111111111010111111010001010101
10000000000001010000000001000110100010000100010100010000000100000000000000010000001000100010004
11111111111111111111111111111111111111111111111111111111111111111111111111111111111111111111111
